Aadorf	Kanton Thurgau
Aarau	Kanton Aargau
Aarberg	Kanton Bern
Aarburg	Kanton Aargau
Aarwangen	Kanton Bern
Abtwil	Kanton Aargau
Aclens	Kanton Waadt
Acquarossa	Kanton Tessin
Adelboden	Kanton Bern
Adligenswil	Kanton Luzern
Adlikon	Kanton Zürich
Adliswil	Kanton Zürich
Aedermannsdorf	Kanton Solothurn
Aefligen	Kanton Bern
Aegerten	Kanton Bern
Aesch	Kanton Basel-Landschaft
Aesch	Kanton Luzern
Aesch	Kanton Zürich
Aeschi	Kanton Solothurn
Aeschi bei Spiez	Kanton Bern
Aeugst am Albis	Kanton Zürich
Affeltrangen	Kanton Thurgau
Affoltern am Albis	Kanton Zürich
Affoltern im Emmental	Kanton Bern
Agarn	Kanton Wallis
Agiez	Kanton Waadt
Agno	Kanton Tessin
Aigle	Kanton Waadt
Aire-la-Ville	Kanton Genf
Airolo	Kanton Tessin
Alberswil	Kanton Luzern
Albinen	Kanton Wallis
Albula	Kanton Graubünden
Alvra	Kanton Graubünden
Alchenstorf	Kanton Bern
Allaman	Kanton Waadt
Alle	Kanton Jura
Allmendingen	Kanton Bern
Allschwil	Kanton Basel-Landschaft
Alpnach	Kanton Obwalden
Alpthal	Kanton Schwyz
Altbüron	Kanton Luzern
Altdorf	Kanton Uri
Altendorf	Kanton Schwyz
Alterswil	Kanton Freiburg
Altikon	Kanton Zürich
Altishofen	Kanton Luzern
Altnau	Kanton Thurgau
Alto Malcantone	Kanton Tessin
Altstätten	Kanton St. Gallen
Altwis	Kanton Luzern
Amden	Kanton St. Gallen
Amlikon-Bissegg	Kanton Thurgau
Ammerswil	Kanton Aargau
Amriswil	Kanton Thurgau
Amsoldingen	Kanton Bern
Andeer	Kanton Graubünden
Andelfingen	Kanton Zürich
Andermatt	Kanton Uri
Andwil	Kanton St. Gallen
Anières	Kanton Genf
Anniviers	Kanton Wallis
Anwil	Kanton Basel-Landschaft
Appenzell	Kanton Appenzell Innerrhoden
Apples	Kanton Waadt
Aranno	Kanton Tessin
Arbaz	Kanton Wallis
Arbedo-Castione	Kanton Tessin
Arboldswil	Kanton Basel-Landschaft
Arbon	Kanton Thurgau
Arch	Kanton Bern
Arconciel	Kanton Freiburg
Ardon	Kanton Wallis
Arisdorf	Kanton Basel-Landschaft
Aristau	Kanton Aargau
Arlesheim	Kanton Basel-Landschaft
Arnex-sur-Nyon	Kanton Waadt
Arnex-sur-Orbe	Kanton Waadt
Arni	Kanton Aargau
Arni	Kanton Bern
Arogno	Kanton Tessin
Arosa	Kanton Graubünden
Arth	Kanton Schwyz
Arzier-Le Muids	Kanton Waadt
Ascona	Kanton Tessin
Assens	Kanton Waadt
Astano	Kanton Tessin
Attalens	Kanton Freiburg
Attinghausen	Kanton Uri
Attiswil	Kanton Bern
Au	Kanton St. Gallen
Aubonne	Kanton Waadt
Auboranges	Kanton Freiburg
Auenstein	Kanton Aargau
Augst	Kanton Basel-Landschaft
Ausserberg	Kanton Wallis
Auswil	Kanton Bern
Autigny	Kanton Freiburg
Auw	Kanton Aargau
Avegno Gordevio	Kanton Tessin
Avenches	Kanton Waadt
Avers	Kanton Graubünden
Avry	Kanton Freiburg
Avully	Kanton Genf
Avusy	Kanton Genf
Ayent	Kanton Wallis
Baar	Kanton Zug
Bachenbülach	Kanton Zürich
Bachs	Kanton Zürich
Bad Ragaz	Kanton St. Gallen
Bad Zurzach	Kanton Aargau
Baden	Kanton Aargau
Bagnes	Kanton Wallis
Baldingen	Kanton Aargau
Balerna	Kanton Tessin
Balgach	Kanton St. Gallen
Ballaigues	Kanton Waadt
Ballens	Kanton Waadt
Ballwil	Kanton Luzern
Balm bei Günsberg	Kanton Solothurn
Balsthal	Kanton Solothurn
Baltschieder	Kanton Wallis
Bannwil	Kanton Bern
Bardonnex	Kanton Genf
Bäretswil	Kanton Zürich
Bargen	Kanton Bern
Bargen	Kanton Schaffhausen
Bäriswil	Kanton Bern
Bärschwil	Kanton Solothurn
Basadingen-Schlattingen	Kanton Thurgau
Basel	Kanton Basel-Stadt
Bas-Intyamon	Kanton Freiburg
Basse-Allaine	Kanton Jura
Bassersdorf	Kanton Zürich
Bassins	Kanton Waadt
Bätterkinden	Kanton Bern
Bättwil	Kanton Solothurn
Bauen	Kanton Uri
Baulmes	Kanton Waadt
Bauma	Kanton Zürich
Bavois	Kanton Waadt
Beatenberg	Kanton Bern
Beckenried	Kanton Nidwalden
Bedano	Kanton Tessin
Bedigliora	Kanton Tessin
Bedretto	Kanton Tessin
Beggingen	Kanton Schaffhausen
Begnins	Kanton Waadt
Beinwil	Kanton Aargau
Beinwil	Kanton Solothurn
Beinwil am See	Kanton Aargau
Belfaux	Kanton Freiburg
Bellach	Kanton Solothurn
Bellevue	Kanton Genf
Bellikon	Kanton Aargau
Bellinzona	Kanton Tessin
Bellmund	Kanton Bern
Bellwald	Kanton Wallis
Belmont-Broye	Kanton Freiburg
Belmont-sur-Lausanne	Kanton Waadt
Belmont-sur-Yverdon	Kanton Waadt
Belp	Kanton Bern
Belprahon	Kanton Bern
Benken	Kanton St. Gallen
Benken	Kanton Zürich
Bennwil	Kanton Basel-Landschaft
Bercher	Kanton Waadt
Berg	Kanton St. Gallen
Berg	Kanton Thurgau
Berg am Irchel	Kanton Zürich
Bergdietikon	Kanton Aargau
Bergün Filisur	Kanton Graubünden
Berikon	Kanton Aargau
Beringen	Kanton Schaffhausen
Berken	Kanton Bern
Berlingen	Kanton Thurgau
Bern	Kanton Bern
Berneck	Kanton St. Gallen
Bernex	Kanton Genf
Berolle	Kanton Waadt
Beromünster	Kanton Luzern
Besenbüren	Kanton Aargau
Bettenhausen	Kanton Bern
Bettens	Kanton Waadt
Bettingen	Kanton Basel-Stadt
Bettlach	Kanton Solothurn
Bettmeralp	Kanton Wallis
Bettwiesen	Kanton Thurgau
Bettwil	Kanton Aargau
Beurnevésin	Kanton Jura
Bever	Kanton Graubünden
Bex	Kanton Waadt
Biasca	Kanton Tessin
Biberist	Kanton Solothurn
Biberstein	Kanton Aargau
Bichelsee-Balterswil	Kanton Thurgau
Biel	Kanton Bern
Bienne	Kanton Bern
Biel-Benken	Kanton Basel-Landschaft
Bière	Kanton Waadt
Biezwil	Kanton Solothurn
Biglen	Kanton Bern
Billens-Hennens	Kanton Freiburg
Binn	Kanton Wallis
Binningen	Kanton Basel-Landschaft
Bioggio	Kanton Tessin
Bioley-Magnoux	Kanton Waadt
Bioley-Orjulaz	Kanton Waadt
Birmensdorf	Kanton Zürich
Birmenstorf	Kanton Aargau
Birr	Kanton Aargau
Birrhard	Kanton Aargau
Birrwil	Kanton Aargau
Birsfelden	Kanton Basel-Landschaft
Birwinken	Kanton Thurgau
Bischofszell	Kanton Thurgau
Bissone	Kanton Tessin
Bister	Kanton Wallis
Bitsch	Kanton Wallis
Blatten	Kanton Wallis
Blauen	Kanton Basel-Landschaft
Bleienbach	Kanton Bern
Blenio	Kanton Tessin
Blonay	Kanton Waadt
Blumenstein	Kanton Bern
Böbikon	Kanton Aargau
Böckten	Kanton Basel-Landschaft
Bodio	Kanton Tessin
Boécourt	Kanton Jura
Bofflens	Kanton Waadt
Bogis-Bossey	Kanton Waadt
Bolken	Kanton Solothurn
Bolligen	Kanton Bern
Boltigen	Kanton Bern
Bonaduz	Kanton Graubünden
Boncourt	Kanton Jura
Bonfol	Kanton Jura
Bönigen	Kanton Bern
Boningen	Kanton Solothurn
Boniswil	Kanton Aargau
Bonstetten	Kanton Zürich
Bonvillars	Kanton Waadt
Boppelsen	Kanton Zürich
Borex	Kanton Waadt
Bosco	Kanton Tessin
Gurin	Kanton Tessin
Bösingen	Kanton Freiburg
Bossonnens	Kanton Freiburg
Boswil	Kanton Aargau
Bottens	Kanton Waadt
Bottenwil	Kanton Aargau
Botterens	Kanton Freiburg
Bottighofen	Kanton Thurgau
Bottmingen	Kanton Basel-Landschaft
Böttstein	Kanton Aargau
Boudry	Kanton Neuenburg
Bougy-Villars	Kanton Waadt
Boulens	Kanton Waadt
Bourg-en-Lavaux	Kanton Waadt
Bourg-Saint-Pierre	Kanton Wallis
Bournens	Kanton Waadt
Bourrignon	Kanton Jura
Boussens	Kanton Waadt
Bovernier	Kanton Wallis
Bowil	Kanton Bern
Bözberg	Kanton Aargau
Bözen	Kanton Aargau
Braunau	Kanton Thurgau
Bregaglia	Kanton Graubünden
Breggia	Kanton Tessin
Breil	Kanton Graubünden
Brigels	Kanton Graubünden
Breitenbach	Kanton Solothurn
Bremblens	Kanton Waadt
Bremgarten	Kanton Aargau
Bremgarten bei Bern	Kanton Bern
Brenzikofen	Kanton Bern
Bretigny-sur-Morrens	Kanton Waadt
Bretonnières	Kanton Waadt
Bretzwil	Kanton Basel-Landschaft
Brienz	Kanton Bern
Brienzwiler	Kanton Bern
Brig-Glis	Kanton Wallis
Brione	Kanton Tessin
Verzasca	Kanton Tessin
Brione sopra Minusio	Kanton Tessin
Brislach	Kanton Basel-Landschaft
Brissago	Kanton Tessin
Brittnau	Kanton Aargau
Broc	Kanton Freiburg
Brot-Plamboz	Kanton Neuenburg
Brugg	Kanton Aargau
Brügg	Kanton Bern
Brunegg	Kanton Aargau
Brünisried	Kanton Freiburg
Brusino Arsizio	Kanton Tessin
Brusio	Kanton Graubünden
Brüttelen	Kanton Bern
Brütten	Kanton Zürich
Bubendorf	Kanton Basel-Landschaft
Bubikon	Kanton Zürich
Buch	Kanton Schaffhausen
Buch am Irchel	Kanton Zürich
Buchberg	Kanton Schaffhausen
Buchegg	Kanton Solothurn
Buchholterberg	Kanton Bern
Buchillon	Kanton Waadt
Buchrain	Kanton Luzern
Buchs	Kanton Aargau
Buchs	Kanton St. Gallen
Buchs	Kanton Zürich
Buckten	Kanton Basel-Landschaft
Büetigen	Kanton Bern
Bühl	Kanton Bern
Bühler	Kanton Appenzell Ausserrhoden
Bülach	Kanton Zürich
Bulle	Kanton Freiburg
Bullet	Kanton Waadt
Bünzen	Kanton Aargau
Buochs	Kanton Nidwalden
Bürchen	Kanton Wallis
Bure	Kanton Jura
Büren	Kanton Solothurn
Büren an der Aare	Kanton Bern
Burg	Kanton Aargau
Burg im Leimental	Kanton Basel-Landschaft
Burgdorf	Kanton Bern
Burgistein	Kanton Bern
Bürglen	Kanton Thurgau
Bürglen	Kanton Uri
Büron	Kanton Luzern
Bursinel	Kanton Waadt
Bursins	Kanton Waadt
Burtigny	Kanton Waadt
Buseno	Kanton Graubünden
Büsserach	Kanton Solothurn
Bussigny	Kanton Waadt
Bussnang	Kanton Thurgau
Busswil bei Melchnau	Kanton Bern
Bussy-Chardonney	Kanton Waadt
Bussy-sur-Moudon	Kanton Waadt
Bütschwil-Ganterschwil	Kanton St. Gallen
Büttenhardt	Kanton Schaffhausen
Büttikon	Kanton Aargau
Buttisholz	Kanton Luzern
Buttwil	Kanton Aargau
Buus	Kanton Basel-Landschaft
Cademario	Kanton Tessin
Cadempino	Kanton Tessin
Cadenazzo	Kanton Tessin
Calanca	Kanton Graubünden
Cama	Kanton Graubünden
Vallemaggia	Kanton Tessin
Campo	Kanton Tessin
Canobbio	Kanton Tessin
Capriasca	Kanton Tessin
Carouge	Kanton Genf
Cartigny	Kanton Genf
Caslano	Kanton Tessin
Castaneda	Kanton Graubünden
Castel San Pietro	Kanton Tessin
Casti-Wergenstein	Kanton Graubünden
Cazis	Kanton Graubünden
Celerina	Kanton Graubünden
Schlarigna	Kanton Graubünden
Céligny	Kanton Genf
Centovalli	Kanton Tessin
Cerentino	Kanton Tessin
Cevio	Kanton Tessin
Chalais	Kanton Wallis
Cham	Kanton Zug
Chamblon	Kanton Waadt
Chamoson	Kanton Wallis
Champagne	Kanton Waadt
Champéry	Kanton Wallis
Champoz	Kanton Bern
Champtauroz	Kanton Waadt
Champvent	Kanton Waadt
Chancy	Kanton Genf
Glâne	Kanton Freiburg
Chapelle	Kanton Freiburg
Chardonne	Kanton Waadt
Charrat	Kanton Wallis
Château-d'Oex	Kanton Waadt
Châtel-Saint-Denis	Kanton Freiburg
Châtel-sur-Montsalvens	Kanton Freiburg
Châtillon	Kanton Freiburg
Châtillon	Kanton Jura
Châtonnaye	Kanton Freiburg
Chavannes-de-Bogis	Kanton Waadt
Chavannes-des-Bois	Kanton Waadt
Chavannes-le-Chêne	Kanton Waadt
Chavannes-le-Veyron	Kanton Waadt
Chavannes-près-Renens	Kanton Waadt
Chavannes-sur-Moudon	Kanton Waadt
Chavornay	Kanton Waadt
Cheiry	Kanton Freiburg
Chêne-Bougeries	Kanton Genf
Chêne-Bourg	Kanton Genf
Chénens	Kanton Freiburg
Chêne-Pâquier	Kanton Waadt
Cheseaux-Noréaz	Kanton Waadt
Cheseaux-sur-Lausanne	Kanton Waadt
Chéserex	Kanton Waadt
Chessel	Kanton Waadt
Chevilly	Kanton Waadt
Chevroux	Kanton Waadt
Chexbres	Kanton Waadt
Cheyres-Châbles	Kanton Freiburg
Chiasso	Kanton Tessin
Chigny	Kanton Waadt
Chippis	Kanton Wallis
Choulex	Kanton Genf
Chur	Kanton Graubünden
Churwalden	Kanton Graubünden
Clarmont	Kanton Waadt
Clavaleyres	Kanton Bern
Clos du Doubs	Kanton Jura
Coeuve	Kanton Jura
Coinsins	Kanton Waadt
Coldrerio	Kanton Tessin
Collex-Bossy	Kanton Genf
Collina d'Oro	Kanton Tessin
Collombey-Muraz	Kanton Wallis
Collonge-Bellerive	Kanton Genf
Collonges	Kanton Wallis
Cologny	Kanton Genf
Comano	Kanton Tessin
Commugny	Kanton Waadt
Concise	Kanton Waadt
Confignon	Kanton Genf
Conters im Prättigau	Kanton Graubünden
Conthey	Kanton Wallis
Coppet	Kanton Waadt
Corbeyrier	Kanton Waadt
Corbières	Kanton Freiburg
Corcelles	Kanton Bern
Corcelles-Cormondrèche	Kanton Neuenburg
Corcelles-le-Jorat	Kanton Waadt
Corcelles-près-Concise	Kanton Waadt
Corcelles-près-Payerne	Kanton Waadt
Corgémont	Kanton Bern
Corippo	Kanton Tessin
Corminboeuf	Kanton Freiburg
Cormoret	Kanton Bern
Cornaux	Kanton Neuenburg
Cornol	Kanton Jura
Corseaux	Kanton Waadt
Corserey	Kanton Freiburg
Corsier	Kanton Genf
Corsier-sur-Vevey	Kanton Waadt
Cortaillod	Kanton Neuenburg
Cortébert	Kanton Bern
Cossonay	Kanton Waadt
Cottens	Kanton Freiburg
Cottens	Kanton Waadt
Courchapoix	Kanton Jura
Courchavon	Kanton Jura
Courgenay	Kanton Jura
Courgevaux	Kanton Freiburg
Courrendlin	Kanton Jura
Courroux	Kanton Jura
Court	Kanton Bern
Courtedoux	Kanton Jura
Courtelary	Kanton Bern
Courtepin	Kanton Freiburg
Courtételle	Kanton Jura
Crans-Montana	Kanton Wallis
Crans-près-Céligny	Kanton Waadt
Crassier	Kanton Waadt
Crémines	Kanton Bern
Cressier	Kanton Freiburg
Cressier	Kanton Neuenburg
Crésuz	Kanton Freiburg
Crissier	Kanton Waadt
Croglio	Kanton Tessin
Cronay	Kanton Waadt
Croy	Kanton Waadt
Cuarnens	Kanton Waadt
Cuarny	Kanton Waadt
Cudrefin	Kanton Waadt
Cugnasco-Gerra	Kanton Tessin
Cugy	Kanton Freiburg
Cugy	Kanton Waadt
Cureglia	Kanton Tessin
Curio	Kanton Tessin
Curtilles	Kanton Waadt
Dachsen	Kanton Zürich
Dägerlen	Kanton Zürich
Dagmersellen	Kanton Luzern
Daillens	Kanton Waadt
Dallenwil	Kanton Nidwalden
Dällikon	Kanton Zürich
Dalpe	Kanton Tessin
Damphreux	Kanton Jura
Däniken	Kanton Solothurn
Dänikon	Kanton Zürich
Dardagny	Kanton Genf
Därligen	Kanton Bern
Därstetten	Kanton Bern
Dättlikon	Kanton Zürich
Davos	Kanton Graubünden
Degersheim	Kanton St. Gallen
Deisswil bei Münchenbuchsee	Kanton Bern
Deitingen	Kanton Solothurn
Delémont	Kanton Jura
Delley-Portalban	Kanton Freiburg
Démoret	Kanton Waadt
Denens	Kanton Waadt
Denges	Kanton Waadt
Densbüren	Kanton Aargau
Derendingen	Kanton Solothurn
Develier	Kanton Jura
Diegten	Kanton Basel-Landschaft
Dielsdorf	Kanton Zürich
Diemerswil	Kanton Bern
Diemtigen	Kanton Bern
Diepflingen	Kanton Basel-Landschaft
Diepoldsau	Kanton St. Gallen
Dierikon	Kanton Luzern
Diessbach bei Büren	Kanton Bern
Diessenhofen	Kanton Thurgau
Dietikon	Kanton Zürich
Dietlikon	Kanton Zürich
Dietwil	Kanton Aargau
Dinhard	Kanton Zürich
Dintikon	Kanton Aargau
Disentis	Kanton Graubünden
Mustér	Kanton Graubünden
Dittingen	Kanton Basel-Landschaft
Dizy	Kanton Waadt
Domat	Kanton Graubünden
Ems	Kanton Graubünden
Domleschg	Kanton Graubünden
Dompierre	Kanton Waadt
Donat	Kanton Graubünden
Donneloye	Kanton Waadt
Doppleschwand	Kanton Luzern
Dorénaz	Kanton Wallis
Dorf	Kanton Zürich
Dörflingen	Kanton Schaffhausen
Dornach	Kanton Solothurn
Dottikon	Kanton Aargau
Döttingen	Kanton Aargau
Dotzigen	Kanton Bern
Dozwil	Kanton Thurgau
Drei Höfe	Kanton Solothurn
Dübendorf	Kanton Zürich
Düdingen	Kanton Freiburg
Duggingen	Kanton Basel-Landschaft
Duillier	Kanton Waadt
Dulliken	Kanton Solothurn
Dully	Kanton Waadt
Dürnten	Kanton Zürich
Dürrenäsch	Kanton Aargau
Dürrenroth	Kanton Bern
Ebersecken	Kanton Luzern
Ebikon	Kanton Luzern
Ebnat-Kappel	Kanton St. Gallen
Echallens	Kanton Waadt
Echandens	Kanton Waadt
Echarlens	Kanton Freiburg
Echichens	Kanton Waadt
Eclépens	Kanton Waadt
Ecublens	Kanton Freiburg
Ecublens	Kanton Waadt
Ederswiler	Kanton Jura
Effingen	Kanton Aargau
Egerkingen	Kanton Solothurn
Egg	Kanton Zürich
Eggenwil	Kanton Aargau
Eggerberg	Kanton Wallis
Eggersriet	Kanton St. Gallen
Eggiwil	Kanton Bern
Eglisau	Kanton Zürich
Egliswil	Kanton Aargau
Egnach	Kanton Thurgau
Egolzwil	Kanton Luzern
Ehrendingen	Kanton Aargau
Eich	Kanton Luzern
Eichberg	Kanton St. Gallen
Eiken	Kanton Aargau
Einsiedeln	Kanton Schwyz
Eischoll	Kanton Wallis
Eisten	Kanton Wallis
Elfingen	Kanton Aargau
Elgg	Kanton Zürich
Ellikon an der Thur	Kanton Zürich
Elsau	Kanton Zürich
Embd	Kanton Wallis
Embrach	Kanton Zürich
Emmen	Kanton Luzern
Emmetten	Kanton Nidwalden
Endingen	Kanton Aargau
Engelberg	Kanton Obwalden
Enges	Kanton Neuenburg
Ennetbaden	Kanton Aargau
Ennetbürgen	Kanton Nidwalden
Ennetmoos	Kanton Nidwalden
Entlebuch	Kanton Luzern
Epalinges	Kanton Waadt
Ependes	Kanton Freiburg
Ependes	Kanton Waadt
Eppenberg-Wöschnau	Kanton Solothurn
Epsach	Kanton Bern
Eptingen	Kanton Basel-Landschaft
Ergisch	Kanton Wallis
Eriswil	Kanton Bern
Eriz	Kanton Bern
Erlach	Kanton Bern
Erlen	Kanton Thurgau
Erlenbach	Kanton Zürich
Erlenbach im Simmental	Kanton Bern
Erlinsbach	Kanton Aargau
Erlinsbach	Kanton Solothurn
Ermatingen	Kanton Thurgau
Ermensee	Kanton Luzern
Ernen	Kanton Wallis
Erschwil	Kanton Solothurn
Ersigen	Kanton Bern
Erstfeld	Kanton Uri
Eschenbach	Kanton Luzern
Eschenbach	Kanton St. Gallen
Eschenz	Kanton Thurgau
Eschert	Kanton Bern
Eschlikon	Kanton Thurgau
Escholzmatt-Marbach	Kanton Luzern
Essertes	Kanton Waadt
Essertines-sur-Rolle	Kanton Waadt
Essertines-sur-Yverdon	Kanton Waadt
Estavayer	Kanton Freiburg
Etagnières	Kanton Waadt
Etoy	Kanton Waadt
Ettingen	Kanton Basel-Landschaft
Ettiswil	Kanton Luzern
Etziken	Kanton Solothurn
Evilard	Kanton Bern
Evionnaz	Kanton Wallis
Evolène	Kanton Wallis
Eysins	Kanton Waadt
Fahrni	Kanton Bern
Fahrwangen	Kanton Aargau
Fahy	Kanton Jura
Faido	Kanton Tessin
Falera	Kanton Graubünden
Fällanden	Kanton Zürich
Faoug	Kanton Waadt
Farnern	Kanton Bern
Féchy	Kanton Waadt
Fehraltorf	Kanton Zürich
Fehren	Kanton Solothurn
Felben-Wellhausen	Kanton Thurgau
Feldbrunnen-St. Niklaus	Kanton Solothurn
Felsberg	Kanton Graubünden
Ferden	Kanton Wallis
Ferenbalm	Kanton Bern
Ferpicloz	Kanton Freiburg
Ferrera	Kanton Graubünden
Ferreyres	Kanton Waadt
Fétigny	Kanton Freiburg
Feuerthalen	Kanton Zürich
Feusisberg	Kanton Schwyz
Fey	Kanton Waadt
Fideris	Kanton Graubünden
Fiesch	Kanton Wallis
Fieschertal	Kanton Wallis
Fiez	Kanton Waadt
Finhaut	Kanton Wallis
Finsterhennen	Kanton Bern
Fischbach	Kanton Luzern
Fischbach-Göslikon	Kanton Aargau
Fischenthal	Kanton Zürich
Fischingen	Kanton Thurgau
Fisibach	Kanton Aargau
Fislisbach	Kanton Aargau
Flaach	Kanton Zürich
Fläsch	Kanton Graubünden
Flawil	Kanton St. Gallen
Flerden	Kanton Graubünden
Flims	Kanton Graubünden
Flüelen	Kanton Uri
Flühli	Kanton Luzern
Flumenthal	Kanton Solothurn
Flums	Kanton St. Gallen
Flurlingen	Kanton Zürich
Fontaines-sur-Grandson	Kanton Waadt
Fontenais	Kanton Jura
Lavaux	Kanton Waadt
Forel	Kanton Waadt
Forst-Längenbühl	Kanton Bern
Founex	Kanton Waadt
Fräschels	Kanton Freiburg
Frasco	Kanton Tessin
Fraubrunnen	Kanton Bern
Frauenfeld	Kanton Thurgau
Frauenkappelen	Kanton Bern
Freienbach	Kanton Schwyz
Freienstein-Teufen	Kanton Zürich
Freienwil	Kanton Aargau
Freimettigen	Kanton Bern
Frenkendorf	Kanton Basel-Landschaft
Fribourg	Kanton Freiburg
Frick	Kanton Aargau
Froideville	Kanton Waadt
Frutigen	Kanton Bern
Fulenbach	Kanton Solothurn
Füllinsdorf	Kanton Basel-Landschaft
Full-Reuenthal	Kanton Aargau
Fully	Kanton Wallis
Furna	Kanton Graubünden
Fürstenau	Kanton Graubünden
Gächlingen	Kanton Schaffhausen
Gachnang	Kanton Thurgau
Gais	Kanton Appenzell Ausserrhoden
Gaiserwald	Kanton St. Gallen
Galgenen	Kanton Schwyz
Galmiz	Kanton Freiburg
Gals	Kanton Bern
Gambarogno	Kanton Tessin
Gampel-Bratsch	Kanton Wallis
Gampelen	Kanton Bern
Gams	Kanton St. Gallen
Gänsbrunnen	Kanton Solothurn
Gansingen	Kanton Aargau
Gebenstorf	Kanton Aargau
Gelterkinden	Kanton Basel-Landschaft
Geltwil	Kanton Aargau
Gempen	Kanton Solothurn
Gempenach	Kanton Freiburg
Genève	Kanton Genf
Genolier	Kanton Waadt
Genthod	Kanton Genf
Gerlafingen	Kanton Solothurn
Geroldswil	Kanton Zürich
Gersau	Kanton Schwyz
Gerzensee	Kanton Bern
Gettnau	Kanton Luzern
Geuensee	Kanton Luzern
Gibloux	Kanton Freiburg
Giebenach	Kanton Basel-Landschaft
Giez	Kanton Waadt
Giffers	Kanton Freiburg
Gilly	Kanton Waadt
Gimel	Kanton Waadt
Gingins	Kanton Waadt
Giornico	Kanton Tessin
Gipf-Oberfrick	Kanton Aargau
Gisikon	Kanton Luzern
Giswil	Kanton Obwalden
Givisiez	Kanton Freiburg
Givrins	Kanton Waadt
Gland	Kanton Waadt
Glarus	Kanton Glarus
Glarus Nord	Kanton Glarus
Glarus Süd	Kanton Glarus
Glattfelden	Kanton Zürich
Gletterens	Kanton Freiburg
Goldach	Kanton St. Gallen
Gollion	Kanton Waadt
Gommiswald	Kanton St. Gallen
Goms	Kanton Wallis
Gondiswil	Kanton Bern
Gonten	Kanton Appenzell Innerrhoden
Gontenschwil	Kanton Aargau
Gordola	Kanton Tessin
Göschenen	Kanton Uri
Gossau	Kanton St. Gallen
Gossau	Kanton Zürich
Gottlieben	Kanton Thurgau
Goumoëns	Kanton Waadt
Graben	Kanton Bern
Grabs	Kanton St. Gallen
Grächen	Kanton Wallis
Grancia	Kanton Tessin
Grancy	Kanton Waadt
Grandcour	Kanton Waadt
Grandevent	Kanton Waadt
Grandfontaine	Kanton Jura
Grandson	Kanton Waadt
Grandval	Kanton Bern
Grandvillard	Kanton Freiburg
Veveyse	Kanton Freiburg
Granges	Kanton Freiburg
Granges-Paccot	Kanton Freiburg
Grangettes	Kanton Freiburg
Gränichen	Kanton Aargau
Gravesano	Kanton Tessin
Greifensee	Kanton Zürich
Grellingen	Kanton Basel-Landschaft
Grenchen	Kanton Solothurn
Greng	Kanton Freiburg
Grengiols	Kanton Wallis
Grens	Kanton Waadt
Greppen	Kanton Luzern
Gretzenbach	Kanton Solothurn
Grimisuat	Kanton Wallis
Grindel	Kanton Solothurn
Grindelwald	Kanton Bern
Grolley	Kanton Freiburg
Grône	Kanton Wallis
Grono	Kanton Graubünden
Grossaffoltern	Kanton Bern
Grossdietwil	Kanton Luzern
Grosshöchstetten	Kanton Bern
Grosswangen	Kanton Luzern
Grub	Kanton Appenzell Ausserrhoden
Grüningen	Kanton Zürich
Grüsch	Kanton Graubünden
Gruyères	Kanton Freiburg
Gryon	Kanton Waadt
Gsteig	Kanton Bern
Gsteigwiler	Kanton Bern
Guggisberg	Kanton Bern
Gündlischwand	Kanton Bern
Günsberg	Kanton Solothurn
Gunzgen	Kanton Solothurn
Gurbrü	Kanton Bern
Gurmels	Kanton Freiburg
Gurtnellen	Kanton Uri
Gurzelen	Kanton Bern
Guttannen	Kanton Bern
Guttet-Feschel	Kanton Wallis
Güttingen	Kanton Thurgau
Gy	Kanton Genf
Habkern	Kanton Bern
Habsburg	Kanton Aargau
Häfelfingen	Kanton Basel-Landschaft
Hagenbuch	Kanton Zürich
Hägendorf	Kanton Solothurn
Häggenschwil	Kanton St. Gallen
Hägglingen	Kanton Aargau
Hagneck	Kanton Bern
Haldenstein	Kanton Graubünden
Hallau	Kanton Schaffhausen
Hallwil	Kanton Aargau
Halten	Kanton Solothurn
Härkingen	Kanton Solothurn
Hasle	Kanton Luzern
Hasle bei Burgdorf	Kanton Bern
Hasliberg	Kanton Bern
Hauenstein-Ifenthal	Kanton Solothurn
Hauptwil-Gottshaus	Kanton Thurgau
Hausen	Kanton Aargau
Hausen am Albis	Kanton Zürich
Haute-Ajoie	Kanton Jura
Hauterive	Kanton Freiburg
Hauterive	Kanton Neuenburg
Haute-Sorne	Kanton Jura
Hauteville	Kanton Freiburg
Haut-Intyamon	Kanton Freiburg
Häutligen	Kanton Bern
Hedingen	Kanton Zürich
Hefenhofen	Kanton Thurgau
Heiden	Kanton Appenzell Ausserrhoden
Heiligenschwendi	Kanton Bern
Heimberg	Kanton Bern
Heimenhausen	Kanton Bern
Heimiswil	Kanton Bern
Heitenried	Kanton Freiburg
Hellikon	Kanton Aargau
Hellsau	Kanton Bern
Hemberg	Kanton St. Gallen
Hemishofen	Kanton Schaffhausen
Hemmiken	Kanton Basel-Landschaft
Hendschiken	Kanton Aargau
Henggart	Kanton Zürich
Henniez	Kanton Waadt
Herbetswil	Kanton Solothurn
Herbligen	Kanton Bern
Herdern	Kanton Thurgau
Hérémence	Kanton Wallis
Hergiswil	Kanton Nidwalden
Hergiswil bei Willisau	Kanton Luzern
Herisau	Kanton Appenzell Ausserrhoden
Hermance	Kanton Genf
Hermenches	Kanton Waadt
Hermrigen	Kanton Bern
Herrliberg	Kanton Zürich
Hersberg	Kanton Basel-Landschaft
Herznach	Kanton Aargau
Herzogenbuchsee	Kanton Bern
Hettlingen	Kanton Zürich
Hildisrieden	Kanton Luzern
Hilterfingen	Kanton Bern
Himmelried	Kanton Solothurn
Hindelbank	Kanton Bern
Hinwil	Kanton Zürich
Hirschthal	Kanton Aargau
Hittnau	Kanton Zürich
Hitzkirch	Kanton Luzern
Hochdorf	Kanton Luzern
Hochfelden	Kanton Zürich
Höchstetten	Kanton Bern
Hochwald	Kanton Solothurn
Hofstetten bei Brienz	Kanton Bern
Hofstetten-Flüh	Kanton Solothurn
Hohenrain	Kanton Luzern
Hohentannen	Kanton Thurgau
Holderbank	Kanton Aargau
Holderbank	Kanton Solothurn
Hölstein	Kanton Basel-Landschaft
Holziken	Kanton Aargau
Homberg	Kanton Bern
Hombrechtikon	Kanton Zürich
Homburg	Kanton Thurgau
Honau	Kanton Luzern
Horgen	Kanton Zürich
Höri	Kanton Zürich
Horn	Kanton Thurgau
Hornussen	Kanton Aargau
Horrenbach-Buchen	Kanton Bern
Horriwil	Kanton Solothurn
Horw	Kanton Luzern
Hospental	Kanton Uri
Hubersdorf	Kanton Solothurn
Humlikon	Kanton Zürich
Hundwil	Kanton Appenzell Ausserrhoden
Hünenberg	Kanton Zug
Hüniken	Kanton Solothurn
Hüntwangen	Kanton Zürich
Hunzenschwil	Kanton Aargau
Hüttikon	Kanton Zürich
Hüttlingen	Kanton Thurgau
Huttwil	Kanton Bern
Hüttwilen	Kanton Thurgau
Icogne	Kanton Wallis
Iffwil	Kanton Bern
Ilanz	Kanton Graubünden
Glion	Kanton Graubünden
Illgau	Kanton Schwyz
Illnau-Effretikon	Kanton Zürich
Inden	Kanton Wallis
Ingenbohl	Kanton Schwyz
Inkwil	Kanton Bern
Innerthal	Kanton Schwyz
Innertkirchen	Kanton Bern
Ins	Kanton Bern
Interlaken	Kanton Bern
Inwil	Kanton Luzern
Ipsach	Kanton Bern
Iseltwald	Kanton Bern
Isenthal	Kanton Uri
Isérables	Kanton Wallis
Islisberg	Kanton Aargau
Isone	Kanton Tessin
Itingen	Kanton Basel-Landschaft
Ittigen	Kanton Bern
Jaberg	Kanton Bern
Jaun	Kanton Freiburg
Jegenstorf	Kanton Bern
Jenaz	Kanton Graubünden
Jenins	Kanton Graubünden
Jens	Kanton Bern
Jonen	Kanton Aargau
Jongny	Kanton Waadt
Jonschwil	Kanton St. Gallen
Jorat-Menthue	Kanton Waadt
Jorat-Mézières	Kanton Waadt
Jouxtens-Mézery	Kanton Waadt
Juriens	Kanton Waadt
Jussy	Kanton Genf
Kaiseraugst	Kanton Aargau
Kaiserstuhl	Kanton Aargau
Kaisten	Kanton Aargau
Kallern	Kanton Aargau
Kallnach	Kanton Bern
Kaltbrunn	Kanton St. Gallen
Kammersrohr	Kanton Solothurn
Kandergrund	Kanton Bern
Kandersteg	Kanton Bern
Känerkinden	Kanton Basel-Landschaft
Kappel	Kanton Solothurn
Kappel am Albis	Kanton Zürich
Kappelen	Kanton Bern
Kaufdorf	Kanton Bern
Kehrsatz	Kanton Bern
Kemmental	Kanton Thurgau
Kernenried	Kanton Bern
Kerns	Kanton Obwalden
Kerzers	Kanton Freiburg
Kesswil	Kanton Thurgau
Kestenholz	Kanton Solothurn
Kienberg	Kanton Solothurn
Kiesen	Kanton Bern
Kilchberg	Kanton Basel-Landschaft
Kilchberg	Kanton Zürich
Killwangen	Kanton Aargau
Kippel	Kanton Wallis
Kirchberg	Kanton Bern
Kirchberg	Kanton St. Gallen
Kirchdorf	Kanton Bern
Kirchenthurnen	Kanton Bern
Kirchleerau	Kanton Aargau
Kirchlindach	Kanton Bern
Kleinandelfingen	Kanton Zürich
Kleinbösingen	Kanton Freiburg
Kleinlützel	Kanton Solothurn
Klingnau	Kanton Aargau
Klosters-Serneus	Kanton Graubünden
Kloten	Kanton Zürich
Knonau	Kanton Zürich
Knutwil	Kanton Luzern
Koblenz	Kanton Aargau
Kölliken	Kanton Aargau
Köniz	Kanton Bern
Konolfingen	Kanton Bern
Koppigen	Kanton Bern
Kradolf-Schönenberg	Kanton Thurgau
Krattigen	Kanton Bern
Krauchthal	Kanton Bern
Kreuzlingen	Kanton Thurgau
Kriechenwil	Kanton Bern
Kriegstetten	Kanton Solothurn
Kriens	Kanton Luzern
Küblis	Kanton Graubünden
Künten	Kanton Aargau
Küsnacht	Kanton Zürich
Küssnacht	Kanton Schwyz
Küttigen	Kanton Aargau
La Baroche	Kanton Jura
La Brévine	Kanton Neuenburg
La Brillaz	Kanton Freiburg
Cossonay	Kanton Waadt
La Chaux	Kanton Waadt
La Chaux-de-Fonds	Kanton Neuenburg
La Chaux-des-Breuleux	Kanton Jura
La Chaux-du-Milieu	Kanton Neuenburg
La Côte-aux-Fées	Kanton Neuenburg
La Ferrière	Kanton Bern
La Folliaz	Kanton Freiburg
La Grande-Béroche	Kanton Neuenburg
La Neuveville	Kanton Bern
La Praz	Kanton Waadt
La Punt-Chamues-ch	Kanton Graubünden
La Rippe	Kanton Waadt
La Roche	Kanton Freiburg
La Sagne	Kanton Neuenburg
La Sarraz	Kanton Waadt
La Sonnaz	Kanton Freiburg
La Tène	Kanton Neuenburg
La Tour-de-Peilz	Kanton Waadt
La Verrerie	Kanton Freiburg
Laax	Kanton Graubünden
L'Abbaye	Kanton Waadt
L'Abergement	Kanton Waadt
Lachen	Kanton Schwyz
Laconnex	Kanton Genf
Lajoux	Kanton Jura
Lalden	Kanton Wallis
Lamone	Kanton Tessin
Lampenberg	Kanton Basel-Landschaft
Lancy	Kanton Genf
Landiswil	Kanton Bern
Landquart	Kanton Graubünden
Langenbruck	Kanton Basel-Landschaft
Langendorf	Kanton Solothurn
Langenthal	Kanton Bern
Langnau am Albis	Kanton Zürich
Langnau im Emmental	Kanton Bern
Langrickenbach	Kanton Thurgau
Lantsch	Kanton Graubünden
Lenz	Kanton Graubünden
Lauenen	Kanton Bern
Lauerz	Kanton Schwyz
Läufelfingen	Kanton Basel-Landschaft
Laufen	Kanton Basel-Landschaft
Laufenburg	Kanton Aargau
Laufen-Uhwiesen	Kanton Zürich
Laupen	Kanton Bern
Laupersdorf	Kanton Solothurn
Lauperswil	Kanton Bern
Lausanne	Kanton Waadt
Lausen	Kanton Basel-Landschaft
Lauterbrunnen	Kanton Bern
Lauwil	Kanton Basel-Landschaft
Lavertezzo	Kanton Tessin
Lavey-Morcles	Kanton Waadt
Lavigny	Kanton Waadt
Lavizzara	Kanton Tessin
Lax	Kanton Wallis
Le Bémont	Kanton Jura
Le Cerneux-Péquignot	Kanton Neuenburg
Le Châtelard	Kanton Freiburg
Le Chenit	Kanton Waadt
Le Flon	Kanton Freiburg
Le Grand-Saconnex	Kanton Genf
Le Landeron	Kanton Neuenburg
Le Lieu	Kanton Waadt
Le Locle	Kanton Neuenburg
Le Mont-sur-Lausanne	Kanton Waadt
Le Mouret	Kanton Freiburg
Le Noirmont	Kanton Jura
Le Pâquier	Kanton Freiburg
Le Vaud	Kanton Waadt
Leibstadt	Kanton Aargau
Leimbach	Kanton Aargau
Leissigen	Kanton Bern
Lengnau	Kanton Aargau
Lengnau	Kanton Bern
Lengwil	Kanton Thurgau
Lenk	Kanton Bern
Lens	Kanton Wallis
Lenzburg	Kanton Aargau
Les Bois	Kanton Jura
Les Brenets	Kanton Neuenburg
Les Breuleux	Kanton Jura
Les Clées	Kanton Waadt
Les Enfers	Kanton Jura
Les Genevez	Kanton Jura
Les Montets	Kanton Freiburg
Les Planchettes	Kanton Neuenburg
Les Ponts-de-Martel	Kanton Neuenburg
Les Verrières	Kanton Neuenburg
Leuggern	Kanton Aargau
Leuk	Kanton Wallis
Leukerbad	Kanton Wallis
Leutwil	Kanton Aargau
Leuzigen	Kanton Bern
Leysin	Kanton Waadt
Leytron	Kanton Wallis
Lichtensteig	Kanton St. Gallen
Liddes	Kanton Wallis
Liedertswil	Kanton Basel-Landschaft
Liesberg	Kanton Basel-Landschaft
Liestal	Kanton Basel-Landschaft
Ligerz	Kanton Bern
Lignerolle	Kanton Waadt
Lignières	Kanton Neuenburg
Lindau	Kanton Zürich
Linden	Kanton Bern
Linescio	Kanton Tessin
L'Isle	Kanton Waadt
Locarno	Kanton Tessin
Lohn	Kanton Graubünden
Lohn	Kanton Schaffhausen
Lohn-Ammannsegg	Kanton Solothurn
Löhningen	Kanton Schaffhausen
Lohnstorf	Kanton Bern
Lommis	Kanton Thurgau
Lommiswil	Kanton Solothurn
Lonay	Kanton Waadt
Longirod	Kanton Waadt
Losone	Kanton Tessin
Lostallo	Kanton Graubünden
Lostorf	Kanton Solothurn
Lotzwil	Kanton Bern
Lovatens	Kanton Waadt
Loveresse	Kanton Bern
Lucens	Kanton Waadt
Lufingen	Kanton Zürich
Lugano	Kanton Tessin
Lugnez	Kanton Jura
Luins	Kanton Waadt
Lully	Kanton Freiburg
Lully	Kanton Waadt
Lumino	Kanton Tessin
Lumnezia	Kanton Graubünden
Lungern	Kanton Obwalden
Lupfig	Kanton Aargau
Lupsingen	Kanton Basel-Landschaft
Lüscherz	Kanton Bern
Lussery-Villars	Kanton Waadt
Lüsslingen-Nennigkofen	Kanton Solothurn
Lussy-sur-Morges	Kanton Waadt
Luterbach	Kanton Solothurn
Lüterkofen-Ichertswil	Kanton Solothurn
Lüterswil-Gächliwil	Kanton Solothurn
Luthern	Kanton Luzern
Lütisburg	Kanton St. Gallen
Lutry	Kanton Waadt
Lütschental	Kanton Bern
Lützelflüh	Kanton Bern
Lutzenberg	Kanton Appenzell Ausserrhoden
Luzein	Kanton Graubünden
Luzern	Kanton Luzern
Lyss	Kanton Bern
Lyssach	Kanton Bern
Madiswil	Kanton Bern
Madulain	Kanton Graubünden
Magden	Kanton Aargau
Mägenwil	Kanton Aargau
Maggia	Kanton Tessin
Magliaso	Kanton Tessin
Maienfeld	Kanton Graubünden
Maisprach	Kanton Basel-Landschaft
Maladers	Kanton Graubünden
Malans	Kanton Graubünden
Malters	Kanton Luzern
Mammern	Kanton Thurgau
Mandach	Kanton Aargau
Männedorf	Kanton Zürich
Manno	Kanton Tessin
Maracon	Kanton Waadt
Marbach	Kanton St. Gallen
Marchissy	Kanton Waadt
Marly	Kanton Freiburg
Maroggia	Kanton Tessin
Marsens	Kanton Freiburg
Märstetten	Kanton Thurgau
Marthalen	Kanton Zürich
Martigny	Kanton Wallis
Martigny-Combe	Kanton Wallis
Maschwanden	Kanton Zürich
Masein	Kanton Graubünden
Massagno	Kanton Tessin
Massongex	Kanton Wallis
Massonnens	Kanton Freiburg
Mathod	Kanton Waadt
Mathon	Kanton Graubünden
Matran	Kanton Freiburg
Matten bei Interlaken	Kanton Bern
Mattstetten	Kanton Bern
Matzendorf	Kanton Solothurn
Matzingen	Kanton Thurgau
Mauborget	Kanton Waadt
Mauensee	Kanton Luzern
Maur	Kanton Zürich
Mauraz	Kanton Waadt
Lucmagn	Kanton Graubünden
Medel	Kanton Graubünden
Meggen	Kanton Luzern
Meienried	Kanton Bern
Meierskappel	Kanton Luzern
Meikirch	Kanton Bern
Meilen	Kanton Zürich
Meinier	Kanton Genf
Meinisberg	Kanton Bern
Meiringen	Kanton Bern
Meisterschwanden	Kanton Aargau
Melano	Kanton Tessin
Melchnau	Kanton Bern
Melide	Kanton Tessin
Mellikon	Kanton Aargau
Mellingen	Kanton Aargau
Mels	Kanton St. Gallen
Meltingen	Kanton Solothurn
Mendrisio	Kanton Tessin
Ménières	Kanton Freiburg
Menziken	Kanton Aargau
Menzingen	Kanton Zug
Menznau	Kanton Luzern
Merenschwand	Kanton Aargau
Mergoscia	Kanton Tessin
Merishausen	Kanton Schaffhausen
Mervelier	Kanton Jura
Merzligen	Kanton Bern
Mesocco	Kanton Graubünden
Messen	Kanton Solothurn
Mettauertal	Kanton Aargau
Mettembert	Kanton Jura
Mettmenstetten	Kanton Zürich
Metzerlen-Mariastein	Kanton Solothurn
Mex	Kanton Waadt
Meyriez	Kanton Freiburg
Meyrin	Kanton Genf
Mézières	Kanton Freiburg
Mezzovico-Vira	Kanton Tessin
Miège	Kanton Wallis
Mies	Kanton Waadt
Miglieglia	Kanton Tessin
Milvignes	Kanton Neuenburg
Minusio	Kanton Tessin
Mirchel	Kanton Bern
Misery-Courtion	Kanton Freiburg
Missy	Kanton Waadt
Möhlin	Kanton Aargau
Moiry	Kanton Waadt
Mollens	Kanton Waadt
Molondin	Kanton Waadt
Mönchaltorf	Kanton Zürich
Montagny	Kanton Freiburg
Montagny-près-Yverdon	Kanton Waadt
Montanaire	Kanton Waadt
Montcherand	Kanton Waadt
Monteceneri	Kanton Tessin
Monteggio	Kanton Tessin
Glâne	Kanton Freiburg
Montet	Kanton Freiburg
Montfaucon	Kanton Jura
Mönthal	Kanton Aargau
Montherod	Kanton Waadt
Monthey	Kanton Wallis
Montilliez	Kanton Waadt
Mont-la-Ville	Kanton Waadt
Mont-Noble	Kanton Wallis
Montpreveyres	Kanton Waadt
Montreux	Kanton Waadt
Montricher	Kanton Waadt
Mont-sur-Rolle	Kanton Waadt
Mont-Tramelan	Kanton Bern
Mont-Vully	Kanton Freiburg
Moosleerau	Kanton Aargau
Moosseedorf	Kanton Bern
Morbio Inferiore	Kanton Tessin
Morcote	Kanton Tessin
Mörel-Filet	Kanton Wallis
Morges	Kanton Waadt
Mörigen	Kanton Bern
Möriken-Wildegg	Kanton Aargau
Morlon	Kanton Freiburg
Morrens	Kanton Waadt
Morschach	Kanton Schwyz
Mörschwil	Kanton St. Gallen
Mosnang	Kanton St. Gallen
Mötschwil	Kanton Bern
Moudon	Kanton Waadt
Moutier	Kanton Bern
Movelier	Kanton Jura
Muhen	Kanton Aargau
Mühlau	Kanton Aargau
Mühleberg	Kanton Bern
Mühlethurnen	Kanton Bern
Müllheim	Kanton Thurgau
Mülligen	Kanton Aargau
Mümliswil-Ramiswil	Kanton Solothurn
Mumpf	Kanton Aargau
Münchenbuchsee	Kanton Bern
Münchenstein	Kanton Basel-Landschaft
Münchenwiler	Kanton Bern
Münchwilen	Kanton Aargau
Münchwilen	Kanton Thurgau
Münsingen	Kanton Bern
Münsterlingen	Kanton Thurgau
Muntelier	Kanton Freiburg
Müntschemier	Kanton Bern
Muolen	Kanton St. Gallen
Muotathal	Kanton Schwyz
Muralto	Kanton Tessin
Murgenthal	Kanton Aargau
Muri	Kanton Aargau
Muri bei Bern	Kanton Bern
Muriaux	Kanton Jura
Murten	Kanton Freiburg
Mutrux	Kanton Waadt
Muttenz	Kanton Basel-Landschaft
Muzzano	Kanton Tessin
Naters	Kanton Wallis
Nebikon	Kanton Luzern
Neckertal	Kanton St. Gallen
Neerach	Kanton Zürich
Neftenbach	Kanton Zürich
Neggio	Kanton Tessin
Nendaz	Kanton Wallis
Nenzlingen	Kanton Basel-Landschaft
Nesslau	Kanton St. Gallen
Neuchâtel	Kanton Neuenburg
Neuendorf	Kanton Solothurn
Neuenegg	Kanton Bern
Neuenhof	Kanton Aargau
Neuenkirch	Kanton Luzern
Neuhausen am Rheinfall	Kanton Schaffhausen
Neuheim	Kanton Zug
Neunforn	Kanton Thurgau
Neunkirch	Kanton Schaffhausen
Neyruz	Kanton Freiburg
Nidau	Kanton Bern
Niederbipp	Kanton Bern
Niederbuchsiten	Kanton Solothurn
Niederbüren	Kanton St. Gallen
Niederdorf	Kanton Basel-Landschaft
Niedergesteln	Kanton Wallis
Niederglatt	Kanton Zürich
Niedergösgen	Kanton Solothurn
Niederhasli	Kanton Zürich
Niederhelfenschwil	Kanton St. Gallen
Niederhünigen	Kanton Bern
Niederlenz	Kanton Aargau
Niedermuhlern	Kanton Bern
Niederönz	Kanton Bern
Niederried bei Interlaken	Kanton Bern
Niederrohrdorf	Kanton Aargau
Niederweningen	Kanton Zürich
Niederwil	Kanton Aargau
Nods	Kanton Bern
Noréaz	Kanton Freiburg
Nottwil	Kanton Luzern
Novaggio	Kanton Tessin
Novalles	Kanton Waadt
Novazzano	Kanton Tessin
Noville	Kanton Waadt
Nuglar-St. Pantaleon	Kanton Solothurn
Nunningen	Kanton Solothurn
Nürensdorf	Kanton Zürich
Nusshof	Kanton Basel-Landschaft
Nuvilly	Kanton Freiburg
Nyon	Kanton Waadt
Oberägeri	Kanton Zug
Oberbalm	Kanton Bern
Oberbipp	Kanton Bern
Oberbuchsiten	Kanton Solothurn
Oberbüren	Kanton St. Gallen
Oberburg	Kanton Bern
Oberdiessbach	Kanton Bern
Oberdorf	Kanton Basel-Landschaft
Oberdorf	Kanton Nidwalden
Oberdorf	Kanton Solothurn
Oberegg	Kanton Appenzell Innerrhoden
Oberembrach	Kanton Zürich
Oberems	Kanton Wallis
Oberengstringen	Kanton Zürich
Oberentfelden	Kanton Aargau
Obergerlafingen	Kanton Solothurn
Oberglatt	Kanton Zürich
Obergoms	Kanton Wallis
Obergösgen	Kanton Solothurn
Oberhallau	Kanton Schaffhausen
Oberhelfenschwil	Kanton St. Gallen
Oberhof	Kanton Aargau
Oberhofen am Thunersee	Kanton Bern
Oberhünigen	Kanton Bern
Oberiberg	Kanton Schwyz
Oberkirch	Kanton Luzern
Oberkulm	Kanton Aargau
Oberlangenegg	Kanton Bern
Oberlunkhofen	Kanton Aargau
Obermumpf	Kanton Aargau
Oberried am Brienzersee	Kanton Bern
Oberrieden	Kanton Zürich
Oberriet	Kanton St. Gallen
Oberrohrdorf	Kanton Aargau
Oberrüti	Kanton Aargau
Obersaxen Mundaun	Kanton Graubünden
Obersiggenthal	Kanton Aargau
Obersteckholz	Kanton Bern
Oberthal	Kanton Bern
Oberuzwil	Kanton St. Gallen
Oberweningen	Kanton Zürich
Oberwil	Kanton Basel-Landschaft
Oberwil bei Büren	Kanton Bern
Oberwil im Simmental	Kanton Bern
Oberwil-Lieli	Kanton Aargau
Obfelden	Kanton Zürich
Ochlenberg	Kanton Bern
Oekingen	Kanton Solothurn
Oensingen	Kanton Solothurn
Oeschenbach	Kanton Bern
Oeschgen	Kanton Aargau
Oetwil am See	Kanton Zürich
Oetwil an der Limmat	Kanton Zürich
Oftringen	Kanton Aargau
Ogens	Kanton Waadt
Ollon	Kanton Waadt
Olsberg	Kanton Aargau
Olten	Kanton Solothurn
Oltingen	Kanton Basel-Landschaft
Onex	Kanton Genf
Onnens	Kanton Waadt
Onsernone	Kanton Tessin
Opfikon	Kanton Zürich
Oppens	Kanton Waadt
Oppligen	Kanton Bern
Orbe	Kanton Waadt
Orges	Kanton Waadt
Origlio	Kanton Tessin
Ormalingen	Kanton Basel-Landschaft
Ormont-Dessous	Kanton Waadt
Ormont-Dessus	Kanton Waadt
Orny	Kanton Waadt
Oron	Kanton Waadt
Orpund	Kanton Bern
Orselina	Kanton Tessin
Orsières	Kanton Wallis
Orvin	Kanton Bern
Orzens	Kanton Waadt
Ossingen	Kanton Zürich
Ostermundigen	Kanton Bern
Otelfingen	Kanton Zürich
Othmarsingen	Kanton Aargau
Ottenbach	Kanton Zürich
Oulens-sous-Echallens	Kanton Waadt
Pailly	Kanton Waadt
Pampigny	Kanton Waadt
Paradiso	Kanton Tessin
Paudex	Kanton Waadt
Payerne	Kanton Waadt
Penthalaz	Kanton Waadt
Penthaz	Kanton Waadt
Penthéréaz	Kanton Waadt
Perly-Certoux	Kanton Genf
Perrefitte	Kanton Bern
Perroy	Kanton Waadt
Personico	Kanton Tessin
Péry-La Heutte	Kanton Bern
Peseux	Kanton Neuenburg
Petit-Val	Kanton Bern
Pfäfers	Kanton St. Gallen
Pfäffikon	Kanton Zürich
Pfaffnau	Kanton Luzern
Pfeffingen	Kanton Basel-Landschaft
Pfungen	Kanton Zürich
Pfyn	Kanton Thurgau
Pierrafortscha	Kanton Freiburg
Pieterlen	Kanton Bern
Plaffeien	Kanton Freiburg
Plan-les-Ouates	Kanton Genf
Plasselb	Kanton Freiburg
Plateau de Diesse	Kanton Bern
Pleigne	Kanton Jura
Pohlern	Kanton Bern
Poliez-Pittet	Kanton Waadt
Pollegio	Kanton Tessin
Pompaples	Kanton Waadt
Pomy	Kanton Waadt
Ponte Capriasca	Kanton Tessin
Ponte Tresa	Kanton Tessin
Pont-en-Ogoz	Kanton Freiburg
Ponthaux	Kanton Freiburg
Pont-la-Ville	Kanton Freiburg
Pontresina	Kanton Graubünden
Porrentruy	Kanton Jura
Port	Kanton Bern
Port-Valais	Kanton Wallis
Porza	Kanton Tessin
Poschiavo	Kanton Graubünden
Prangins	Kanton Waadt
Leventina	Kanton Tessin
Prato	Kanton Tessin
Pratteln	Kanton Basel-Landschaft
Pregny-Chambésy	Kanton Genf
Premier	Kanton Waadt
Presinge	Kanton Genf
Préverenges	Kanton Waadt
Prévondavaux	Kanton Freiburg
Prévonloup	Kanton Waadt
Prez-vers-Noréaz	Kanton Freiburg
Prilly	Kanton Waadt
Provence	Kanton Waadt
Puidoux	Kanton Waadt
Pully	Kanton Waadt
Puplinge	Kanton Genf
Pura	Kanton Tessin
Quarten	Kanton St. Gallen
Quinto	Kanton Tessin
Radelfingen	Kanton Bern
Rafz	Kanton Zürich
Rain	Kanton Luzern
Ramlinsburg	Kanton Basel-Landschaft
Ramsen	Kanton Schaffhausen
Rances	Kanton Waadt
Randa	Kanton Wallis
Raperswilen	Kanton Thurgau
Rapperswil	Kanton Bern
Rapperswil-Jona	Kanton St. Gallen
Raron	Kanton Wallis
Realp	Kanton Uri
Rebeuvelier	Kanton Jura
Rebstein	Kanton St. Gallen
Recherswil	Kanton Solothurn
Rechthalten	Kanton Freiburg
Reconvilier	Kanton Bern
Regensberg	Kanton Zürich
Regensdorf	Kanton Zürich
Rehetobel	Kanton Appenzell Ausserrhoden
Reichenbach im Kandertal	Kanton Bern
Reichenburg	Kanton Schwyz
Reiden	Kanton Luzern
Reigoldswil	Kanton Basel-Landschaft
Reinach	Kanton Aargau
Reinach	Kanton Basel-Landschaft
Reisiswil	Kanton Bern
Reitnau	Kanton Aargau
Rekingen	Kanton Aargau
Remaufens	Kanton Freiburg
Remetschwil	Kanton Aargau
Remigen	Kanton Aargau
Renan	Kanton Bern
Renens	Kanton Waadt
Rennaz	Kanton Waadt
Reute	Kanton Appenzell Ausserrhoden
Reutigen	Kanton Bern
Reverolle	Kanton Waadt
Rhäzüns	Kanton Graubünden
Rheinau	Kanton Zürich
Rheineck	Kanton St. Gallen
Rheinfelden	Kanton Aargau
Rheinwald	Kanton Graubünden
Riaz	Kanton Freiburg
Richterswil	Kanton Zürich
Rickenbach	Kanton Basel-Landschaft
Rickenbach	Kanton Luzern
Rickenbach	Kanton Solothurn
Rickenbach	Kanton Thurgau
Rickenbach	Kanton Zürich
Riddes	Kanton Wallis
Ried bei Kerzers	Kanton Freiburg
Ried-Brig	Kanton Wallis
Riederalp	Kanton Wallis
Riedholz	Kanton Solothurn
Riehen	Kanton Basel-Stadt
Riemenstalden	Kanton Schwyz
Rietheim	Kanton Aargau
Rifferswil	Kanton Zürich
Riggisberg	Kanton Bern
Ringgenberg	Kanton Bern
Riniken	Kanton Aargau
Risch	Kanton Zug
Riva San Vitale	Kanton Tessin
Rivaz	Kanton Waadt
Riviera	Kanton Tessin
Roche	Kanton Waadt
Rochefort	Kanton Neuenburg
Roches	Kanton Bern
Rodersdorf	Kanton Solothurn
Roggenburg	Kanton Basel-Landschaft
Roggliswil	Kanton Luzern
Roggwil	Kanton Bern
Roggwil	Kanton Thurgau
Rohr	Kanton Solothurn
Rohrbach	Kanton Bern
Rohrbachgraben	Kanton Bern
Rolle	Kanton Waadt
Romainmôtier-Envy	Kanton Waadt
Romanel-sur-Lausanne	Kanton Waadt
Romanel-sur-Morges	Kanton Waadt
Romanshorn	Kanton Thurgau
Römerswil	Kanton Luzern
Romont	Kanton Bern
Romont	Kanton Freiburg
Romoos	Kanton Luzern
Ronco sopra Ascona	Kanton Tessin
Rongellen	Kanton Graubünden
Root	Kanton Luzern
Ropraz	Kanton Waadt
Rorbas	Kanton Zürich
Rorschach	Kanton St. Gallen
Rorschacherberg	Kanton St. Gallen
Röschenz	Kanton Basel-Landschaft
Rossa	Kanton Graubünden
Rossemaison	Kanton Jura
Rossenges	Kanton Waadt
Rossinière	Kanton Waadt
Röthenbach im Emmental	Kanton Bern
Rothenbrunnen	Kanton Graubünden
Rothenburg	Kanton Luzern
Rothenfluh	Kanton Basel-Landschaft
Rothenthurm	Kanton Schwyz
Rothrist	Kanton Aargau
Rottenschwil	Kanton Aargau
Rougemont	Kanton Waadt
Roveredo	Kanton Graubünden
Rovio	Kanton Tessin
Rovray	Kanton Waadt
Rubigen	Kanton Bern
Rüderswil	Kanton Bern
Rüdlingen	Kanton Schaffhausen
Rudolfstetten-Friedlisberg	Kanton Aargau
Rüdtligen-Alchenflüh	Kanton Bern
Rue	Kanton Freiburg
Rüeggisberg	Kanton Bern
Rüegsau	Kanton Bern
Rueyres	Kanton Waadt
Rüfenach	Kanton Aargau
Rumendingen	Kanton Bern
Rümikon	Kanton Aargau
Rumisberg	Kanton Bern
Rümlang	Kanton Zürich
Rümligen	Kanton Bern
Rümlingen	Kanton Basel-Landschaft
Rünenberg	Kanton Basel-Landschaft
Rupperswil	Kanton Aargau
Rüschegg	Kanton Bern
Rüschlikon	Kanton Zürich
Russikon	Kanton Zürich
Russin	Kanton Genf
Ruswil	Kanton Luzern
Rüte	Kanton Appenzell Innerrhoden
Rüthi	Kanton St. Gallen
Rüti	Kanton Zürich
Rüti bei Büren	Kanton Bern
Rüti bei Lyssach	Kanton Bern
Rütschelen	Kanton Bern
Rüttenen	Kanton Solothurn
Saanen	Kanton Bern
Saas-Almagell	Kanton Wallis
Saas-Balen	Kanton Wallis
Saas-Fee	Kanton Wallis
Saas-Grund	Kanton Wallis
Sachseln	Kanton Obwalden
Safenwil	Kanton Aargau
Safiental	Kanton Graubünden
Safnern	Kanton Bern
Sagogn	Kanton Graubünden
Saicourt	Kanton Bern
Saignelégier	Kanton Jura
Saillon	Kanton Wallis
Saint-Aubin	Kanton Freiburg
Saint-Barthélemy	Kanton Waadt
Saint-Blaise	Kanton Neuenburg
Saint-Brais	Kanton Jura
Saint-Cergue	Kanton Waadt
Sainte-Croix	Kanton Waadt
Saint-George	Kanton Waadt
Saint-Gingolph	Kanton Wallis
Saint-Imier	Kanton Bern
Saint-Légier-La Chiésaz	Kanton Waadt
Saint-Léonard	Kanton Wallis
Saint-Livres	Kanton Waadt
Saint-Martin	Kanton Freiburg
Saint-Martin	Kanton Wallis
Saint-Maurice	Kanton Wallis
Saint-Oyens	Kanton Waadt
Saint-Prex	Kanton Waadt
Lavaux	Kanton Waadt
Saint-Saphorin	Kanton Waadt
Saint-Sulpice	Kanton Waadt
Salenstein	Kanton Thurgau
Sâles	Kanton Freiburg
Salgesch	Kanton Wallis
Salmsach	Kanton Thurgau
Salvan	Kanton Wallis
Samedan	Kanton Graubünden
Samnaun	Kanton Graubünden
San Vittore	Kanton Graubünden
Santa Maria in Calanca	Kanton Graubünden
Sant'Antonino	Kanton Tessin
Sargans	Kanton St. Gallen
Sarmenstorf	Kanton Aargau
Sarnen	Kanton Obwalden
Satigny	Kanton Genf
Sattel	Kanton Schwyz
Saubraz	Kanton Waadt
Sauge	Kanton Bern
Saulcy	Kanton Jura
Saules	Kanton Bern
Savièse	Kanton Wallis
Savigny	Kanton Waadt
Savosa	Kanton Tessin
Saxeten	Kanton Bern
Saxon	Kanton Wallis
Schaffhausen	Kanton Schaffhausen
Schafisheim	Kanton Aargau
S-chanf	Kanton Graubünden
Schangnau	Kanton Bern
Schänis	Kanton St. Gallen
Scharans	Kanton Graubünden
Schattdorf	Kanton Uri
Schattenhalb	Kanton Bern
Schelten	Kanton Bern
Schenkon	Kanton Luzern
Scheuren	Kanton Bern
Schiers	Kanton Graubünden
Schinznach	Kanton Aargau
Schinznach-Bad	Kanton Aargau
Schlatt	Kanton Thurgau
Schlatt	Kanton Zürich
Schlatt-Haslen	Kanton Appenzell Innerrhoden
Schleinikon	Kanton Zürich
Schleitheim	Kanton Schaffhausen
Schlierbach	Kanton Luzern
Schlieren	Kanton Zürich
Schlossrued	Kanton Aargau
Schluein	Kanton Graubünden
Schmerikon	Kanton St. Gallen
Schmiedrued	Kanton Aargau
Schmitten	Kanton Freiburg
Schmitten	Kanton Graubünden
Schneisingen	Kanton Aargau
Schnottwil	Kanton Solothurn
Schöfflisdorf	Kanton Zürich
Schöftland	Kanton Aargau
Schönenbuch	Kanton Basel-Landschaft
Schönengrund	Kanton Appenzell Ausserrhoden
Schönenwerd	Kanton Solothurn
Schongau	Kanton Luzern
Schönholzerswilen	Kanton Thurgau
Schötz	Kanton Luzern
Schübelbach	Kanton Schwyz
Schupfart	Kanton Aargau
Schüpfen	Kanton Bern
Schüpfheim	Kanton Luzern
Schwaderloch	Kanton Aargau
Schwadernau	Kanton Bern
Schwanden bei Brienz	Kanton Bern
Schwarzenberg	Kanton Luzern
Schwarzenburg	Kanton Bern
Schwarzhäusern	Kanton Bern
Schwellbrunn	Kanton Appenzell Ausserrhoden
Schwende	Kanton Appenzell Innerrhoden
Schwendibach	Kanton Bern
Schwerzenbach	Kanton Zürich
Schwyz	Kanton Schwyz
Scuol	Kanton Graubünden
Seeberg	Kanton Bern
Seedorf	Kanton Bern
Seedorf	Kanton Uri
Seegräben	Kanton Zürich
Seehof	Kanton Bern
Seelisberg	Kanton Uri
Seengen	Kanton Aargau
Seewen	Kanton Solothurn
Seewis im Prättigau	Kanton Graubünden
Seftigen	Kanton Bern
Seltisberg	Kanton Basel-Landschaft
Selzach	Kanton Solothurn
Sembrancher	Kanton Wallis
Sempach	Kanton Luzern
Semsales	Kanton Freiburg
Senarclens	Kanton Waadt
Senèdes	Kanton Freiburg
Sennwald	Kanton St. Gallen
Seon	Kanton Aargau
Sergey	Kanton Waadt
Serravalle	Kanton Tessin
Servion	Kanton Waadt
Sessa	Kanton Tessin
Seuzach	Kanton Zürich
Sévaz	Kanton Freiburg
Sevelen	Kanton St. Gallen
Sévery	Kanton Waadt
Siblingen	Kanton Schaffhausen
Sierre	Kanton Wallis
Siglistorf	Kanton Aargau
Signau	Kanton Bern
Signy-Avenex	Kanton Waadt
Sigriswil	Kanton Bern
Silenen	Kanton Uri
Sils im Domleschg	Kanton Graubünden
Sils im Engadin	Kanton Graubünden
Segl	Kanton Graubünden
Silvaplana	Kanton Graubünden
Simplon	Kanton Wallis
Sins	Kanton Aargau
Sion	Kanton Wallis
Sirnach	Kanton Thurgau
Siselen	Kanton Bern
Sisikon	Kanton Uri
Sissach	Kanton Basel-Landschaft
Sisseln	Kanton Aargau
Siviriez	Kanton Freiburg
Soazza	Kanton Graubünden
Solothurn	Kanton Solothurn
Sommeri	Kanton Thurgau
Sonceboz-Sombeval	Kanton Bern
Sonogno	Kanton Tessin
Sonvilier	Kanton Bern
Soral	Kanton Genf
Sorengo	Kanton Tessin
Sorens	Kanton Freiburg
Sorvilier	Kanton Bern
Soubey	Kanton Jura
Soyhières	Kanton Jura
Speicher	Kanton Appenzell Ausserrhoden
Spiez	Kanton Bern
Spiringen	Kanton Uri
Spreitenbach	Kanton Aargau
St. Antoni	Kanton Freiburg
St. Gallen	Kanton St. Gallen
St. Margrethen	Kanton St. Gallen
St. Moritz	Kanton Graubünden
St. Niklaus	Kanton Wallis
St. Silvester	Kanton Freiburg
St. Stephan	Kanton Bern
St. Ursen	Kanton Freiburg
Stabio	Kanton Tessin
Stadel	Kanton Zürich
Stäfa	Kanton Zürich
Staffelbach	Kanton Aargau
Stalden	Kanton Wallis
Staldenried	Kanton Wallis
Stallikon	Kanton Zürich
Stammheim	Kanton Zürich
Stans	Kanton Nidwalden
Stansstad	Kanton Nidwalden
Starrkirch-Wil	Kanton Solothurn
Staufen	Kanton Aargau
Steckborn	Kanton Thurgau
Steffisburg	Kanton Bern
Steg-Hohtenn	Kanton Wallis
Stein	Kanton Aargau
Stein	Kanton Appenzell Ausserrhoden
Stein am Rhein	Kanton Schaffhausen
Steinach	Kanton St. Gallen
Steinen	Kanton Schwyz
Steinerberg	Kanton Schwyz
Steinhausen	Kanton Zug
Steinmaur	Kanton Zürich
Stetten	Kanton Aargau
Stetten	Kanton Schaffhausen
Stettfurt	Kanton Thurgau
Stettlen	Kanton Bern
Stocken-Höfen	Kanton Bern
Strengelbach	Kanton Aargau
Studen	Kanton Bern
Stüsslingen	Kanton Solothurn
Subingen	Kanton Solothurn
Suchy	Kanton Waadt
Sufers	Kanton Graubünden
Suhr	Kanton Aargau
Sulgen	Kanton Thurgau
Sullens	Kanton Waadt
Sumiswald	Kanton Bern
Sumvitg	Kanton Graubünden
Surpierre	Kanton Freiburg
Sursee	Kanton Luzern
Surses	Kanton Graubünden
Suscévaz	Kanton Waadt
Sutz-Lattrigen	Kanton Bern
Syens	Kanton Waadt
Tafers	Kanton Freiburg
Tägerig	Kanton Aargau
Tägerwilen	Kanton Thurgau
Tamins	Kanton Graubünden
Tannay	Kanton Waadt
Tartegnin	Kanton Waadt
Täsch	Kanton Wallis
Täuffelen	Kanton Bern
Tavannes	Kanton Bern
Tecknau	Kanton Basel-Landschaft
Tegerfelden	Kanton Aargau
Tenero-Contra	Kanton Tessin
Tenniken	Kanton Basel-Landschaft
Tentlingen	Kanton Freiburg
Termen	Kanton Wallis
Terre di Pedemonte	Kanton Tessin
Teufen	Kanton Appenzell Ausserrhoden
Teufenthal	Kanton Aargau
Teuffenthal	Kanton Bern
Tévenon	Kanton Waadt
Thal	Kanton St. Gallen
Thalheim	Kanton Aargau
Thalheim an der Thur	Kanton Zürich
Thalwil	Kanton Zürich
Thayngen	Kanton Schaffhausen
Therwil	Kanton Basel-Landschaft
Thierachern	Kanton Bern
Thônex	Kanton Genf
Thörigen	Kanton Bern
Thun	Kanton Bern
Thundorf	Kanton Thurgau
Thunstetten	Kanton Bern
Thürnen	Kanton Basel-Landschaft
Thusis	Kanton Graubünden
Titterten	Kanton Basel-Landschaft
Tobel-Tägerschen	Kanton Thurgau
Toffen	Kanton Bern
Tolochenaz	Kanton Waadt
Törbel	Kanton Wallis
Torny	Kanton Freiburg
Torricella-Taverne	Kanton Tessin
Trachselwald	Kanton Bern
Tramelan	Kanton Bern
Trasadingen	Kanton Schaffhausen
Treiten	Kanton Bern
Trélex	Kanton Waadt
Trey	Kanton Waadt
Treycovagnes	Kanton Waadt
Payerne	Kanton Waadt
Treytorrens	Kanton Waadt
Treyvaux	Kanton Freiburg
Triengen	Kanton Luzern
Trient	Kanton Wallis
Trimbach	Kanton Solothurn
Trimmis	Kanton Graubünden
Trin	Kanton Graubünden
Trogen	Kanton Appenzell Ausserrhoden
Troinex	Kanton Genf
Troistorrents	Kanton Wallis
Trub	Kanton Bern
Trubschachen	Kanton Bern
Trüllikon	Kanton Zürich
Trun	Kanton Graubünden
Truttikon	Kanton Zürich
Tschappina	Kanton Graubünden
Tschiertschen-Praden	Kanton Graubünden
Tschugg	Kanton Bern
Tübach	Kanton St. Gallen
Tuggen	Kanton Schwyz
Tujetsch	Kanton Graubünden
Turbenthal	Kanton Zürich
Turgi	Kanton Aargau
Turtmann-Unterems	Kanton Wallis
Twann-Tüscherz	Kanton Bern
Udligenswil	Kanton Luzern
Ueberstorf	Kanton Freiburg
Uebeschi	Kanton Bern
Ueken	Kanton Aargau
Uerkheim	Kanton Aargau
Uesslingen-Buch	Kanton Thurgau
Uetendorf	Kanton Bern
Uetikon am See	Kanton Zürich
Uezwil	Kanton Aargau
Ufhusen	Kanton Luzern
Uitikon	Kanton Zürich
Ulmiz	Kanton Freiburg
Unterägeri	Kanton Zug
Unterbäch	Kanton Wallis
Untereggen	Kanton St. Gallen
Unterengstringen	Kanton Zürich
Unterentfelden	Kanton Aargau
Unteriberg	Kanton Schwyz
Unterkulm	Kanton Aargau
Unterlangenegg	Kanton Bern
Unterlunkhofen	Kanton Aargau
Unterramsern	Kanton Solothurn
Unterschächen	Kanton Uri
Unterseen	Kanton Bern
Untersiggenthal	Kanton Aargau
Untervaz	Kanton Graubünden
Urdorf	Kanton Zürich
Urmein	Kanton Graubünden
Urnäsch	Kanton Appenzell Ausserrhoden
Ursenbach	Kanton Bern
Ursins	Kanton Waadt
Ursy	Kanton Freiburg
Urtenen-Schönbühl	Kanton Bern
Uster	Kanton Zürich
Uttigen	Kanton Bern
Uttwil	Kanton Thurgau
Utzenstorf	Kanton Bern
Uznach	Kanton St. Gallen
Uzwil	Kanton St. Gallen
Vacallo	Kanton Tessin
Val Müstair	Kanton Graubünden
Val Terbi	Kanton Jura
Valangin	Kanton Neuenburg
Valbirse	Kanton Bern
Valbroye	Kanton Waadt
Val-de-Charmey	Kanton Freiburg
Val-de-Ruz	Kanton Neuenburg
Val-de-Travers	Kanton Neuenburg
Val-d'Illiez	Kanton Wallis
Valeyres-sous-Montagny	Kanton Waadt
Valeyres-sous-Rances	Kanton Waadt
Valeyres-sous-Ursins	Kanton Waadt
Vallon	Kanton Freiburg
Vallorbe	Kanton Waadt
Vals	Kanton Graubünden
Valsot	Kanton Graubünden
Vandoeuvres	Kanton Genf
Varen	Kanton Wallis
Vaulion	Kanton Waadt
Vaulruz	Kanton Freiburg
Vaux-sur-Morges	Kanton Waadt
Vaz	Kanton Graubünden
Obervaz	Kanton Graubünden
Vechigen	Kanton Bern
Veltheim	Kanton Aargau
Vendlincourt	Kanton Jura
Venthône	Kanton Wallis
Vernate	Kanton Tessin
Vernayaz	Kanton Wallis
Vernier	Kanton Genf
Vérossaz	Kanton Wallis
Versoix	Kanton Genf
Vétroz	Kanton Wallis
Vevey	Kanton Waadt
Vex	Kanton Wallis
Veyras	Kanton Wallis
Veyrier	Kanton Genf
Veysonnaz	Kanton Wallis
Veytaux	Kanton Waadt
Vezia	Kanton Tessin
Vich	Kanton Waadt
Vico Morcote	Kanton Tessin
Villarsel-sur-Marly	Kanton Freiburg
Villars-Epeney	Kanton Waadt
Villars-le-Comte	Kanton Waadt
Villars-le-Terroir	Kanton Waadt
Villars-Sainte-Croix	Kanton Waadt
Villars-sous-Yens	Kanton Waadt
Villars-sur-Glâne	Kanton Freiburg
Villarzel	Kanton Waadt
Villaz-Saint-Pierre	Kanton Freiburg
Villeneuve	Kanton Waadt
Villeret	Kanton Bern
Villigen	Kanton Aargau
Villmergen	Kanton Aargau
Villnachern	Kanton Aargau
Villorsonnens	Kanton Freiburg
Vilters-Wangs	Kanton St. Gallen
Vinelz	Kanton Bern
Vinzel	Kanton Waadt
Vionnaz	Kanton Wallis
Visp	Kanton Wallis
Visperterminen	Kanton Wallis
Vitznau	Kanton Luzern
Vogorno	Kanton Tessin
Volken	Kanton Zürich
Volketswil	Kanton Zürich
Vollèges	Kanton Wallis
Vordemwald	Kanton Aargau
Vorderthal	Kanton Schwyz
Vouvry	Kanton Wallis
Vuadens	Kanton Freiburg
Vuarrens	Kanton Waadt
Vucherens	Kanton Waadt
Vufflens-la-Ville	Kanton Waadt
Vufflens-le-Château	Kanton Waadt
Vugelles-La Mothe	Kanton Waadt
Vuisternens-devant-Romont	Kanton Freiburg
Vuiteboeuf	Kanton Waadt
Vulliens	Kanton Waadt
Vullierens	Kanton Waadt
Vully-les-Lacs	Kanton Waadt
Wachseldorn	Kanton Bern
Wädenswil	Kanton Zürich
Wagenhausen	Kanton Thurgau
Wahlen	Kanton Basel-Landschaft
Walchwil	Kanton Zug
Wald	Kanton Appenzell Ausserrhoden
Wald	Kanton Bern
Wald	Kanton Zürich
Waldenburg	Kanton Basel-Landschaft
Wäldi	Kanton Thurgau
Waldkirch	Kanton St. Gallen
Waldstatt	Kanton Appenzell Ausserrhoden
Walenstadt	Kanton St. Gallen
Walkringen	Kanton Bern
Wallbach	Kanton Aargau
Wallisellen	Kanton Zürich
Walliswil bei Niederbipp	Kanton Bern
Walliswil bei Wangen	Kanton Bern
Walperswil	Kanton Bern
Waltenschwil	Kanton Aargau
Walterswil	Kanton Bern
Walterswil	Kanton Solothurn
Walzenhausen	Kanton Appenzell Ausserrhoden
Wangen	Kanton Schwyz
Wangen an der Aare	Kanton Bern
Wangen bei Olten	Kanton Solothurn
Wangen-Brüttisellen	Kanton Zürich
Wangenried	Kanton Bern
Wängi	Kanton Thurgau
Wartau	Kanton St. Gallen
Warth-Weiningen	Kanton Thurgau
Wassen	Kanton Uri
Wasterkingen	Kanton Zürich
Wattenwil	Kanton Bern
Wattwil	Kanton St. Gallen
Wauwil	Kanton Luzern
Weesen	Kanton St. Gallen
Wegenstetten	Kanton Aargau
Weggis	Kanton Luzern
Weiach	Kanton Zürich
Weinfelden	Kanton Thurgau
Weiningen	Kanton Zürich
Weisslingen	Kanton Zürich
Welschenrohr	Kanton Solothurn
Wengi	Kanton Bern
Wenslingen	Kanton Basel-Landschaft
Werthenstein	Kanton Luzern
Wettingen	Kanton Aargau
Wettswil am Albis	Kanton Zürich
Wetzikon	Kanton Zürich
Wichtrach	Kanton Bern
Widen	Kanton Aargau
Widnau	Kanton St. Gallen
Wiedlisbach	Kanton Bern
Wiesendangen	Kanton Zürich
Wiggiswil	Kanton Bern
Wigoltingen	Kanton Thurgau
Wikon	Kanton Luzern
Wil	Kanton St. Gallen
Wil	Kanton Zürich
Wila	Kanton Zürich
Wilchingen	Kanton Schaffhausen
Wildberg	Kanton Zürich
Wilderswil	Kanton Bern
Wildhaus-Alt St. Johann	Kanton St. Gallen
Wilen	Kanton Thurgau
Lötschen	Kanton Wallis
Wiler	Kanton Wallis
Wiler bei Utzenstorf	Kanton Bern
Wileroltigen	Kanton Bern
Wiliberg	Kanton Aargau
Willadingen	Kanton Bern
Willisau	Kanton Luzern
Wimmis	Kanton Bern
Windisch	Kanton Aargau
Winkel	Kanton Zürich
Wintersingen	Kanton Basel-Landschaft
Winterthur	Kanton Zürich
Winznau	Kanton Solothurn
Wisen	Kanton Solothurn
Wislikofen	Kanton Aargau
Wittenbach	Kanton St. Gallen
Witterswil	Kanton Solothurn
Wittinsburg	Kanton Basel-Landschaft
Wittnau	Kanton Aargau
Wohlen	Kanton Aargau
Wohlen bei Bern	Kanton Bern
Wohlenschwil	Kanton Aargau
Wolfenschiessen	Kanton Nidwalden
Wolfhalden	Kanton Appenzell Ausserrhoden
Wolfisberg	Kanton Bern
Wölflinswil	Kanton Aargau
Wolfwil	Kanton Solothurn
Wolhusen	Kanton Luzern
Wollerau	Kanton Schwyz
Worb	Kanton Bern
Worben	Kanton Bern
Wünnewil-Flamatt	Kanton Freiburg
Wuppenau	Kanton Thurgau
Würenlingen	Kanton Aargau
Würenlos	Kanton Aargau
Wynau	Kanton Bern
Wynigen	Kanton Bern
Wyssachen	Kanton Bern
Yens	Kanton Waadt
Yverdon-les-Bains	Kanton Waadt
Yvonand	Kanton Waadt
Yvorne	Kanton Waadt
Zäziwil	Kanton Bern
Zeglingen	Kanton Basel-Landschaft
Zeihen	Kanton Aargau
Zeiningen	Kanton Aargau
Zell	Kanton Luzern
Zell	Kanton Zürich
Zeneggen	Kanton Wallis
Zermatt	Kanton Wallis
Zernez	Kanton Graubünden
Zetzwil	Kanton Aargau
Ziefen	Kanton Basel-Landschaft
Zielebach	Kanton Bern
Zihlschlacht-Sitterdorf	Kanton Thurgau
Zillis-Reischen	Kanton Graubünden
Zizers	Kanton Graubünden
Zofingen	Kanton Aargau
Zollikofen	Kanton Bern
Zollikon	Kanton Zürich
Zuchwil	Kanton Solothurn
Zufikon	Kanton Aargau
Zug	Kanton Zug
Zullwil	Kanton Solothurn
Zumikon	Kanton Zürich
Zunzgen	Kanton Basel-Landschaft
Zuoz	Kanton Graubünden
Zürich	Kanton Zürich
Zuzgen	Kanton Aargau
Zuzwil	Kanton Bern
Zuzwil	Kanton St. Gallen
Zweisimmen	Kanton Bern
Zwieselberg	Kanton Bern
Zwingen	Kanton Basel-Landschaft
Zwischbergen	Kanton Wallis
